11111111111111111111111111111111
10000C01000000000000000001000101
10010001000000000000000001000101
10011111000000000E00000001000101
10000000000000000000000001000101
10000000101111111111110001000101
100000001000000C0000000001000101
10000000111111111111100001000101
1000000010000000000C100001000101
10000000100000000000100001000101
10000000101111111111100001000101
10000000100000000000100001000101
1P000000111111111110100001000101
10000000100000000000000001000101
11111111111111111111111111111111