1111111111111111
100100000000C001
10000011C0000001
1P001111110000C1
1001111E00100001
1111111111111111