11111111111111111111111111111111
10000C00000000000000000001000101
10000000000000000000000001000101
10000000000000000E00000001000101
10000000000000000000000001000101
10000000000000000000000001000101
100000000000000C0000000001000101
10000000000000000000000001000101
100000000C0000000000000001000101
10000000000000000000000001000101
10000000000000000000000001000101
10000000000000000000000001000101
1P000000000000000000000001000101
10000000000000000000000001000101
11111111111111111111111111111111