111111111111111111111111111111
10000C000000000000000000010001
100000000000000000000000010001
10000000000000000E000000010001
100000000000000C00000000010001
100000000000000000000000010001
100000000C00000000000000010001
100000000000000000000000010001
1P0000000000000000000000010001
100000000000000000000000010001
111111111111111111111111111111