1111111111111111
100100000000C001
10000011C0000001
11001111C10000C1
1001111E00000001
1111111111111111