1111111111111111
1001000000000001
1000001110000001
1P00111111000001
1001111E00000001
1111111111111111